Your family has been poor your whole life. You work hard, for little reward. But all that is about to change. You traded your family's only cow to this old man for some magic beans! Clearly you got the better side of the deal. "Some people just don't know what they have, until they lose it," you say to yourself, whistling as you head home.

Beans Talk
An Interactive Fiction by Douglas Kiang
Release 1 / Serial number 190224 / Inform 7 build 6M62 (I6/v6.33 lib 6/12N) SD

Cottage
Home sweet home! You are back home in your cozy cottage with a straw roof and thin, threadbare walls. The garden is to the south.

I beg your pardon?

>s
Garden
The garden is hot and dry and offers little in the way of shade. This used to grow a meager supply of vegetables for your family to subsist on but lately the ground has dried out and very little grows here now. There is a hose attached to a spigot on the side of the house. The Cottage is to the north.

You can see Toyota (empty) and a watering can (empty) here.

>enter Toyota.
You get into Toyota.

>restart
Are you sure you want to restart?

>y
Your family has been poor your whole life. You work hard, for little reward. But all that is about to change. You traded your family's only cow to this old man for some magic beans! Clearly you got the better side of the deal. "Some people just don't know what they have, until they lose it," you say to yourself, whistling as you head home.

InformTest
An Interactive Fiction by Douglas Kiang
Release 1 / Serial number 190213 / Inform 7 build 6M62 (I6/v6.33 lib 6/12N) SD

Cottage
Home sweet home! You are back home in your cozy cottage with a straw roof and thin, threadbare walls. The garden is to the south.

>l
Cottage
Home sweet home! You are back home in your cozy cottage with a straw roof and thin, threadbare walls. The garden is to the south.

>x walls
You can't see any such thing.

>x roof
You can't see any such thing.

* * *

>beans
That's not a verb I recognise.

>x beans
They are rainbow-colored, shiny, and slightly warm to the touch, as if they have some strange, magical power. Or it could just be because they've been sitting in your pocket all day. You can't wait to plant them in the ground and see what sprouts.

>s
Garden
The garden is hot and dry and offers little in the way of shade. This used to grow a meager supply of vegetables for your family to subsist on but lately the ground has dried out and very little grows here now. There is a hose attached to a spigot on the side of the house. The Cottage is to the north.

You can see a watering can (empty) here.

>x ground
 The ground is baked by the sun and is hard and dry. Nothing can be planted here yet.

>plant beans in ground
The ground is too dry.

* * *

>i
You are carrying:
  magic beans

>x magic beans
They are rainbow-colored, shiny, and slightly warm to the touch, as if they have some strange, magical power. Or it could be just because they've been in your pocket all day.

>x me
As good-looking as ever.

* * *

>x magic beans
They are rainbow-colored, shiny, and slightly warm to the touch, as if they have some strange, magical power. Or it could be just because they've been in your pocket all day.

>x player
You can't see any such thing.

>x me
Magic beans

* * *

>s
Garden
The garden is hot and dry and offers little in the way of shade. This used to grow a meager supply of vegetables for your family to subsist on but lately the ground has dried out and very little grows here now. There is a hose attached to a spigot on the side of the house. The Cottage is to the north.

You can see Spigot and a watering can (empty) here.

>plant beans in groun
You can't see any such thing.

>plant beans in ground
The ground is too dry.

* * *

>s
Garden
The garden is hot and dry and offers little in the way of shade. This used to grow a meager supply of vegetables for your family to subsist on but lately the ground has dried out and very little grows here now. There is a hose attached to a spigot on the side of the house. The Cottage is to the north.

You can see Spigot and a watering can (empty) here.

>put beans in ground
That can't contain things.

>plant beans in ground
You plant the beans in the ground and before you can cover them up they have sprouted!

* * *

>s
Garden
The garden is hot and dry and offers little in the way of shade. This used to grow a meager supply of vegetables for your family to subsist on but lately the ground has dried out and very little grows here now. There is a hose attached to a spigot on the side of the house. The Cottage is to the north.

You can see Spigot and a watering can (empty) here.

>s
Entry Hall

>s
(first unlocking the oak door with the brass key, then opening the door) 

Billiard Room
The Billiard Room

* * *

>s
Garden
The garden is hot and dry and offers little in the way of shade. This used to grow a meager supply of vegetables for your family to subsist on but lately the ground has dried out and very little grows here now. There is a hose attached to a spigot on the side of the house. The Cottage is to the north.

You can see Spigot and a watering can (empty) here.

>take watering can
Taken.

>x can
An old rusty watering can.

>x ground
The ground is baked by the sun and is hard and dry. Nothing can be planted here unless it rains.

>x hose
The hose is about six feet long and is made of green rubber. It is attached tightly to the spigot.

>take hose
You can't detach the hose from the spigot.

* * *

>s
Garden
The garden is hot and dry and offers little in the way of shade. This used to grow a meager supply of vegetables for your family to subsist on but lately the ground has dried out and very little grows here now. There is a hose attached to a spigot on the side of the house. The Cottage is to the north.

You can see Spigot and a watering can (empty) here.

>turn on spigot
You turn on spigot. The water rushes out of the other end of the hose and vanishes into the ground, several feet short of the garden. WIth a heavy sigh, you turn the spigot off.

>open spigot
Try turning it on.

* * *

>s
Garden
The garden is hot and dry and offers little in the way of shade. This used to grow a meager supply of vegetables for your family to subsist on but lately the ground has dried out and very little grows here now. There is a hose attached to a spigot on the side of the house. The Cottage is to the north.

You can see Spigot and a watering can (empty) here.

>x ground
 The soil is moist and dark brown, in contrast to the rest of the garden.

>take can
Taken.

>x can
An old rusty watering can.

* * *

>x ground
 The soil is moist and dark brown, in contrast to the rest of the garden.

>x ground
 The soil is moist and dark brown, in contrast to the rest of the garden.

* * *

>s
Garden
The garden is hot and dry and offers little in the way of shade. This used to grow a meager supply of vegetables for your family to subsist on but lately the ground has dried out and very little grows here now. There is a hose attached to a spigot on the side of the house. The Cottage is to the north.

You can see Spigot and a watering can (empty) here.

>x spigot
An old spigot.

>x nozzle
An old spigot.